111111111111111
1P0011100000001
1C0011111111001
100011000000001
10000000C000001
100E0000C000E01
100111100011001
111111111111111
