1111111
100P001
10C0EN1
1111111
