111111111111
10100E010P01
1010C001C001
101100111101
10N000000001
111111111111
